[
  [2, 11, 11, 11, 11, 11, 11, 11, 11, 11, 11, 11, 11, 44, 43, 11, 11, 11, 11, 11, 11, 11, 11, 11, 11, 11, 11, 1],
  [4, 0, 0, 0, 0, 0, 0, 0, 0, 0, 0, 0, 0, 26, 25, 0, 0, 0, 0, 0, 0, 0, 0, 0, 0, 0, 0, 3],
  [4, 0, 24, 15, 15, 23, 0, 24, 15, 15, 15, 23, 0, 26, 25, 0, 24, 15, 15, 15, 23, 0, 24, 15, 15, 23, 0, 3],
  [4, 0, 26, 0, 0, 25, 0, 26, 0, 0, 0, 25, 0, 26, 25, 0, 26, 0, 0, 0, 25, 0, 26, 0, 0, 25, 0, 3],
  [4, -1],
  [4, -1],
  [4, -1],
  [4, -1],
  [4, -1],
  [6, -1],
  [0, -1],
  [0, -1],
  [0, -1],
  [11, -1],
  [0, -1],
  [13, -1],
  [0, -1],
  [0, -1],
  [0, -1],
  [2, -1],
  [4, -1],
  [4, -1],
  [4, -1],
  [4, -1],
  [8, -1],
  [10, -1],
  [4, -1],
  [4, -1],
  [4, -1],
  [4, -1],
  [6, 13, 13, 13, 13, 13, 13, 13, 13, 13, 13, 13, 13, 13, 13, 13, 13, 13, 13, 13, 13, 13, 13, 13, 13, 13, 13, 5]
]
